48 c7 c7 80 89 60 55 c3
00 00 00 00 00 00 00 00
00 00 00 00 00 00 00 00
00 00 00 00 00 00 00 00
00 00 00 00 00 00 00 00
00 00 00 00 00 00 00 00
00 00 00 00 00 00 00 00
38 89 60 55 00 00 00 00
5f 13 40 00 00 00 00 00
37 30 33 30 34 36 66 61 00